.................
.................
@................
#####.###########

.................
.................
@................
#####...#########

.................
.................
@................
#####.##.########

.................
.................
...o..@..........
#####.#.##.##.###

.................
.................
...@.............
#####..#.########
E false
H true

J false
